1111111111111
1001000000001
1000011PC1001
100011E000C01
1111111111111