1111111111111111111111111111111111111111111111111111111111111111111111111111111111111111111111111111111111111111
1010010000100000101000000000010111111111111111111111111111111111111111110000000000000000000000000000000000000001
1011110010101010001111000000010111111111111111111111111111111111111111110000000000000000000000000000000000000001
1P1111111111111C00001C011111111111111111111111111111111111111111111111110000000000000000000000000000000000000001
100000000C00C0000001E0000000000000000000000000000000000000000000000000000000000000000000000000000000000000000001
1000000000000000000111000000000000000000000000000000000000000000000000000000000000000000000000000000000000000001
1000000000000000000000000000000000000000000000000000000000000000000000000000000000000000000000000000000000000001
10000000000000000000000000000000000000000000000000000000000000000000000000000000000000000000000000000C0000000001
10000000000000000000000C0000000000000000000000000000000000000000000000000000000000000000000000000000000000000001
10000000001111110000000C0000000000000000000000000000000000000000000000000000000000000000000000000000000000000001
10000000001000010000000C0000000000000000000000000000000000000000000000000000000000000000000000000000000000000001
10000000001000010000000C0000000000000000000000000000000000000000000000000000000000000000000000000000000000000001
10000000001111110000000C0000000000000000000000000000000000000000000000000000000000000000000000000000000000000001
10000000000000000000000C0000000000000000000000000000000000000000000000000000000000000000000000000000000000000001
10000000000000000000000C0000000000000000000000000000000000000000000000000000000000000000000000000000000000000001
10000000000000000000000C000000000000000000000000011100000000000000000000000000000000000000000000000000C000000001
10000000000000000000000C0000000000000000000000000111000000000000000000000000000000000000000000000000000000001111
10000000000000000000000C0000000000000000000000000010000000000000000000000000000000000000000000000000000000000001
1000000000000000000000111111100000000000000000111111111000000000000000000000000000000000000000000000000000000001
10000000000000000000000CC000100000000000000000000010000000000000000000000000000000000000000000000000000000000001
111111111111111C00001C011111100000000000000000000010000000000000000000010000000000000000000000000000000000000001
1010010000100000101000000000000000000000000000000010000000000000000000010000000000000000000000000000000000000001
1011110010101010001111000000000000000000000000000101000000000000000000010000000000000000000000000000000000000001
100000000C00C000000100000000000000000000000000001000100000000000000000000000000000000000000000000000000000000001
1000000000000000000111000000000000000000000000001000100000000000000000000000000000000000000000000000000000000001
1000000000000000000000000000000000000000000000001000100000000000000000000000000000000000000000000000000000000001
1000000000000000000000000000000000000000000000000000000000000000000000000000000000000000000000000000000000000001
10000000000000000000000C0000000000000000000000000000000000000000000000000000000000000000000000000000000000000001
10000000000000000000000C0000000000000000000000000000000000000000000000000000000000000000000000000000000000000001
10000000000000000000000C0000000000000000000000000000000000000000000000000000000000000000000000000000000000000001
10000000000000000000000C0000000000000000000000000000000000000000000000000000000000000000000000000000000000000001
10000000000000000000000C0000000000000000000000000000000000000000000000000000000000000000000000000000000000000001
10000000000000000000000C0000000000000000000000000000000000000000000000000000000000000000000000000000000000000001
10000000000000000000000C0000000000000000000000000000000000000000000000000000000000000000000000000000000000000001
10000000000000000000000C0000000000000000000000000000000000000000000000000000000000000000000000000000000000000001
10000000000000000000000C0000000000000000000000000000000000000000000000000000000000000000000000000000000000000001
10000000000000000000000C0000000000000000000000000000000000000000000000000000000000000000000000000000000000000001
10000000000000000000000C0000000000000000000000000000000000000000000000000000000000000000000000000000000000000001
1000000000000000000000111111100000000000000000000000000000000000000000000000000000000000000000000000000000000001
10000000000000000000000C0000100000000000000000000000000000000000000000000000000000000000000000000000000000000001
1000000000000000000000111111100000000000000000000000000000000000000000000000000000000000000000000000000000000001
1000000000000000000000111111100000000000000000000000000000000000000000000000000000000000000000000000000000000001
1000000000000000000000111011100000000000000000000000000000000000000000000000000000000000000000000000000000000001
1000000000000000000000111111100000000000000000000000000000000000000000000000000000000000000000000000000000000001
1000000000000000000000111111100000000000000000000000000000000000000000000000000000000000000000000000000000000001
1000000000000000000000111111100000000000000000000000000000000000000000000000000000000000000000000000000000000001
10000000000000000000000C0000000000000000000000000000000000000000000000000000000000000000000000000000000000000001
10000000000000000000000C0000000000000000000000000000000000000000000000000000000000000000000000000000000000000001
10000000000000000000000C0000000000000000000000000000000000000000000000000000000000000000000000000000000000000001
10000000000000000000000C0000000000000000000000000000000000000000000000000000000000000000000000000000000000000001
10000000000000000000000C0000000000000000000000000000000000000000000000000000000000000000000000000000000000000001
10000000000000000000000C0000000000000000000000000000000000000000000000000000000000000000000000000000000000000001
10000000000000000000000C0000000000000000000000000000000000000000000000000000000000000000000000000000000000000001
10000000000000000000000C0000000000000000000000000000000000000000000000000000000000000000000000000000000000000001
10000000000000000000000C0000000000000000000000000000000000000000000000000000000000000000000000000000000000000001
1000000000000000000000111111100000000000000000000000000000000000000000000000000000000000000000000000000000000001
10000000000000000000000C00C0100000000000000000000000000000000000000000000000000000000000000000000000000000000001
1000000000000000000000111111100000000000000000000000000000000000000000000000000000000000000000000000000000000001
1000000000000000000000111111100000000000000000000000000000000000000000000000000000000000000000000000000000000001
1000000000000000000000111011100000000000000000000000000000000000000000000000000000000000000000000000000000000001
1000000000000000000000111111100000000000000000000000000000000000000000000000000000000000000000000000000000000001
1000000000000000000000111111100000000000000000000000000000000000000000000000000000000000000000000000000000000001
1000000000000000000000111111100000000000000000000000000000000000000000000000000000000000000000000000000000000001
10000000000000000000000C0000000000000000000000000000000000000000000000000000000000000000000000000000000000000001
10000000000000000000000C0000000000000000000000000000000000000000000000000000000000000000000000000000000000000001
10000000000000000000000C0000000000000000000000000000000000000000000000000000000000000000000000000000000000000001
10000000000000000000000C0000000000000000000000000000000000000000000000000000000000000000000000000000000000000001
10000000000000000000000C0000000000000000000000000000000000000000000000000000000000000000000000000000000000000001
10000000000000000000000C0000000000000000000000000000000000000000000000000000000000000000000000000000000000000001
10000000000000000000000C0000000000000000000000000000000000000000000000000000000000000000000000000000000000000001
10000000000000000000000C0000000000000000000000000000000000000000000000000000000000000000000000000000000000000001
10000000000000000000000C0000000000000000000000000000000000000000000000000000000000000000000000000000000000000001
1000000000000000000000111111100000000000000000000000000000000000000000000000000000000000000000000000000000000001
10000000000000000000000C0000100000000000000000000000000000000000000000000000000000000000000000000000000000000001
1000000000000000000000111111100000000000000000000000000000000000000000000000000000000000000000000000000000000001
1000000000000000000000111111100000000000000000000000000000000000000000000000000000000000000000000000000000000001
1000000000000000000000111111100000000000000000000000000000000000000000000000000000000000000000000000000000000001
1000000000000000000000111111100000000000000000000000000000000000000000000000000000000000000000000000000000000001
1000000000000000000000111111100000000000000000000000000000000000000000000000000000000000000000000000000000000001
1000000000000000000000111111100000000000000000000000000000000000000000000000000000000000000000000000000000000001
1111111111111111111111111111111111111111111111111111111111111111111111111111111111111111111111111111111111111111