111111111111111111111111
111111110000000C00000C01
101001010010000010100101
101001000010101000100101
100000000C00C00000000001
101000001010101000100101
101000001010101000100101
101000010010000010100101
1010C0010010000010100101
101000001010101000100101
101001010000000010100101
1C10P100101010100000E001
111111111111111111111111