11111111111111111
10000000000000001
1010C101001010101
10100100101010101
1E0000000C000P001
11111111111111111