111111111111111111111111111111
1000000000000C000000C0000001C1
1010C101000100000100000101C001
101001010101010101010101010101
1010000000000C0000000000C00101
1C10C1010001001001001001010101
101001010101000P01000001010101
1000000000000C0000000000000101
1000C1010001001001000001010101
101001010101000001010001010001
1010000000000C0000000C00000001
1010C1010001001001001001010001
1C10010101010101010101C10100E1
111111111111111111111111111111